11111111111111
10000000000001
1P0000C0000C01
10011111111001
1000CC00C000E1
11111111111111
