111111111
100000001
1PCE00001
111111111







1111111
1000001
1000001
100C001
1111111
