1111111111
100000PEC1
1000!00001
1000000001
1000000001
1111111111
