1111111111111
1000000000001
10000PCE00001
1000D00000001
1111111111111
