111111111
1000PE001
100000001
111111111
