1111111
1000001
1CC0P01
1111111
