11111111
1P000001
10111101
10001001
11101001
10001101
10111001
10001011
11101001
10001101
10101EC1
10001011
10111001
10001101
10111001
10000011
11111111
