11111111
1000001
1P000001
10C0E001
11111111
