1111111
100PCE1
1000001
1100011
 11111
