1111111111111111
1000000000000001
1P00000000000001
10000E0000000001
1000000000001111
1000000000001C11
1111111111111111
