111111111
1000000P1
101C1C1C1
101111111
101C1C1C1
100000001
1C1111101
101C11101
1000C1101
101C11101
1C111E001
111111111
