11111111
1E000001
10C11101
1011CC01
10C11101
10111C01
100000P1
11111111
