1111111111111
1P00000000001
1000000000001
1001100011001
100110O011001
100C0C0C0C001
10O0C0C0C0O01
100C0C0C0C001
100110O011001
1001100011001
1000000000001
10000000000E1
1111111111111
