111111111111111
100000000000001
101111111111101
101000000000101
101011111110101
101010000010101
101010111010101
101010EP1010101
101011111010101
101000000010101
101111111110101
100000000000101
111111111111101
1C0000000000001
111111111111111
