11111111111111111
10P01O00C0C0000O1
10001001111110001
100000000O0011011
100010O0000011011
111110000O0010001
10000011110011011
10111110000011011
1C00O00011101C0C1
111CC1111O1O10E01
11111111111111111
