1111111111111111111111111111111111111111
1000000000000000000C0C0C0000000000000001
1011111110011111111111110000000000000001
10100P0010010C0C000C0C010001C01C01C01C01
111C000C1111C0C0C1COC0C10001001001001001
10111011100111011111011100010C10C10C10C1
1000000000000000010000000001001001001001
10000000C00000000100O0000001C01C01C01C01
1000OO0C0C000000010000000000000000000001
10000000C00001111111111111100111OO111001
1000100000000100000CC0000010001111110001
100111000000010O0CC00CC00O10000111100001
1011111000000100C001100C0010000011000001
10C0C0C000000100C010010C0010000000000001
10001000O0O0010C01000010C0100OO000OO0001
1O0111000000110C01000010C010000011000001
1011111000000000C010010C0010000111100001
10C0C0C000000000C001100C0010001111110001
111111111111110O0CC00CC000100111CC111001
10O0000000O00100000CC000O0100O0000O00001
1000C1C000000100O00000O0001000C000100001
1000111000O11111111111111111100C01110001
1000C1C00001CC11CC1111CC11CC100C00100001
1000000000000000000110000000000000000001
1011111110000000000110000000000111111101
101C0C0C100111110001100011111001C0E0C101
1010C0C01001C1C1000110001C1C100100000101
1011101110O0000000O00000O000000111011101
1O00000000000O000000000000000000000000O1
1111111111111111111111111111111111111111
