111111111111111
1000000P0000001
1011CC1101000C1
10COOOOC0100CO1
10COOOOC0100CO1
1011CC110100CO1
100000000100CO1
111111111100CO1
100000000000CO1
10CCCCCC0000CO1
10COOOOC00000C1
10COOOOC0011111
10CCCCCC0010E01
100000000011C11
100111111111011
100100000010001
100101111010001
1000COOOOC00001
111111111111111
