1111111111111111111
1000000000000000001
1000000000000000001
1000000000000000001
1000000000000000001
10000000O0000000001
1000000000000000001
1000000000000000001
1000000000000000001
100000000000000PCE1
1111111111111111111
