111111111111111
1P00000000000E1
100001000100001
10001C101C10001
100000000000001
101000000000101
100110000011001
100001111100001
100000000000001
111111111111111
