111111111111111111111111111111111111111
1P0CCCCCCCCCCCCCCCCCCCCCCCCCCCCCCCCCCC1
1011111111111111111111111111111111111C1
1E0CCCCCCCCCCCCCCCCCCCCCCCCCCCCCCCCCCC1
111111111111111111111111111111111111111
