11111111111
11111P11111
11111011111
11OOOCOOO11
1OOOOCOOOO1
1OOOOCOOOO1
11OOOCOOO11
11111C11111
11111C11111
11OOOCOOO11
1OOOOCOOOO1
1OOOOCOOOO1
1OOOOCOOOO1
1OOOOCOOOO1
11OOOCOOO11
11111011111
11111011111
11110001111
11110E01111
11111111111
