1111
10O1
1111
1PC1
1E01
1111
