111111111111111111111
100000000000000000001
10O0O0O0O0O0O0O0O0O01
100O0O0O0O0O0O0O0O0O1
111111111111111111111
1PCE00000000000000001
111111111111111111111
